15.ox
.............
.o..oo.......
........o....
...o.........
......oo..o.o
.............
..oo..o..o...
..o.o......o.
...o.....o...
.......o.....
.o.....o.....
......o......
........o....
...........o.
.............
